"filename", "language", "Markdown", "Docker", "XML", "YAML", "Java", "comment", "blank", "total"
"c:\Users\ahmed\OneDrive\Desktop\information\college\second term year 3\oop\project\IDS\README.Docker.md", "Markdown", 13, 0, 0, 0, 0, 0, 6, 19
"c:\Users\ahmed\OneDrive\Desktop\information\college\second term year 3\oop\project\IDS\README.md", "Markdown", 12, 0, 0, 0, 0, 0, 1, 13
"c:\Users\ahmed\OneDrive\Desktop\information\college\second term year 3\oop\project\IDS\compose.yaml", "YAML", 0, 0, 0, 20, 0, 0, 3, 23
"c:\Users\ahmed\OneDrive\Desktop\information\college\second term year 3\oop\project\IDS\dockerfile", "Docker", 0, 27, 0, 0, 0, 50, 20, 97
"c:\Users\ahmed\OneDrive\Desktop\information\college\second term year 3\oop\project\IDS\pom.xml", "XML", 0, 0, 125, 0, 0, 14, 16, 155
"c:\Users\ahmed\OneDrive\Desktop\information\college\second term year 3\oop\project\IDS\src\main\java\com\example\App.java", "Java", 0, 0, 0, 0, 24, 32, 12, 68
"c:\Users\ahmed\OneDrive\Desktop\information\college\second term year 3\oop\project\IDS\src\main\java\com\example\Main.java", "Java", 0, 0, 0, 0, 8, 1, 2, 11
"c:\Users\ahmed\OneDrive\Desktop\information\college\second term year 3\oop\project\IDS\src\main\java\com\example\PacketFactoryPattern\LivePacketReader.java", "Java", 0, 0, 0, 0, 39, 1, 9, 49
"c:\Users\ahmed\OneDrive\Desktop\information\college\second term year 3\oop\project\IDS\src\main\java\com\example\PacketFactoryPattern\OfflinePacketReader.java", "Java", 0, 0, 0, 0, 25, 0, 7, 32
"c:\Users\ahmed\OneDrive\Desktop\information\college\second term year 3\oop\project\IDS\src\main\java\com\example\PacketFactoryPattern\PacketReader.java", "Java", 0, 0, 0, 0, 6, 0, 3, 9
"c:\Users\ahmed\OneDrive\Desktop\information\college\second term year 3\oop\project\IDS\src\main\java\com\example\PacketFactoryPattern\PacketReaderFactory.java", "Java", 0, 0, 0, 0, 12, 11, 3, 26
"c:\Users\ahmed\OneDrive\Desktop\information\college\second term year 3\oop\project\IDS\src\main\java\com\example\concurrent\DatabaseConnectionBools.java", "Java", 0, 0, 0, 0, 39, 1, 12, 52
"c:\Users\ahmed\OneDrive\Desktop\information\college\second term year 3\oop\project\IDS\src\main\java\com\example\concurrent\PoolManager.java", "Java", 0, 0, 0, 0, 45, 6, 9, 60
"c:\Users\ahmed\OneDrive\Desktop\information\college\second term year 3\oop\project\IDS\src\main\java\com\example\concurrent\RuleQueue.java", "Java", 0, 0, 0, 0, 10, 0, 6, 16
"c:\Users\ahmed\OneDrive\Desktop\information\college\second term year 3\oop\project\IDS\src\main\java\com\example\consumer\Consumer.java", "Java", 0, 0, 0, 0, 22, 1, 3, 26
"c:\Users\ahmed\OneDrive\Desktop\information\college\second term year 3\oop\project\IDS\src\main\java\com\example\database\ElasticSearch\App.java", "Java", 0, 0, 0, 0, 89, 1, 19, 109
"c:\Users\ahmed\OneDrive\Desktop\information\college\second term year 3\oop\project\IDS\src\main\java\com\example\database\ElasticSearch\DNSHeader.java", "Java", 0, 0, 0, 0, 9, 0, 4, 13
"c:\Users\ahmed\OneDrive\Desktop\information\college\second term year 3\oop\project\IDS\src\main\java\com\example\database\ElasticSearch\ElasticsearchManager.java", "Java", 0, 0, 0, 0, 203, 1, 18, 222
"c:\Users\ahmed\OneDrive\Desktop\information\college\second term year 3\oop\project\IDS\src\main\java\com\example\database\ElasticSearch\EthernetHeader.java", "Java", 0, 0, 0, 0, 12, 0, 5, 17
"c:\Users\ahmed\OneDrive\Desktop\information\college\second term year 3\oop\project\IDS\src\main\java\com\example\database\ElasticSearch\IDSAlert.java", "Java", 0, 0, 0, 0, 27, 3, 8, 38
"c:\Users\ahmed\OneDrive\Desktop\information\college\second term year 3\oop\project\IDS\src\main\java\com\example\database\ElasticSearch\IPv4Header.java", "Java", 0, 0, 0, 0, 15, 0, 6, 21
"c:\Users\ahmed\OneDrive\Desktop\information\college\second term year 3\oop\project\IDS\src\main\java\com\example\database\ElasticSearch\PacketData.java", "Java", 0, 0, 0, 0, 18, 0, 7, 25
"c:\Users\ahmed\OneDrive\Desktop\information\college\second term year 3\oop\project\IDS\src\main\java\com\example\database\ElasticSearch\UDPHeader.java", "Java", 0, 0, 0, 0, 9, 0, 4, 13
"c:\Users\ahmed\OneDrive\Desktop\information\college\second term year 3\oop\project\IDS\src\main\java\com\example\database\mysql\Alerts.java", "Java", 0, 0, 0, 0, 72, 1, 18, 91
"c:\Users\ahmed\OneDrive\Desktop\information\college\second term year 3\oop\project\IDS\src\main\java\com\example\database\mysql\Rules.java", "Java", 0, 0, 0, 0, 60, 2, 7, 69
"c:\Users\ahmed\OneDrive\Desktop\information\college\second term year 3\oop\project\IDS\src\main\java\com\example\database\mysql\User.java", "Java", 0, 0, 0, 0, 49, 0, 21, 70
"c:\Users\ahmed\OneDrive\Desktop\information\college\second term year 3\oop\project\IDS\src\main\java\com\example\designpatterns\ObserverPattern\Observer.java", "Java", 0, 0, 0, 0, 4, 0, 2, 6
"c:\Users\ahmed\OneDrive\Desktop\information\college\second term year 3\oop\project\IDS\src\main\java\com\example\designpatterns\ObserverPattern\Subject.java", "Java", 0, 0, 0, 0, 6, 0, 1, 7
"c:\Users\ahmed\OneDrive\Desktop\information\college\second term year 3\oop\project\IDS\src\main\java\com\example\designpatterns\ProducerConsumer\ProducerConsumer.java", "Java", 0, 0, 0, 0, 27, 0, 9, 36
"c:\Users\ahmed\OneDrive\Desktop\information\college\second term year 3\oop\project\IDS\src\main\java\com\example\designpatterns\StrategyPattern\ConsumerStrategy.java", "Java", 0, 0, 0, 0, 6, 0, 3, 9
"c:\Users\ahmed\OneDrive\Desktop\information\college\second term year 3\oop\project\IDS\src\main\java\com\example\designpatterns\StrategyPattern\ProducerStrategy.java", "Java", 0, 0, 0, 0, 6, 0, 1, 7
"c:\Users\ahmed\OneDrive\Desktop\information\college\second term year 3\oop\project\IDS\src\main\java\com\example\engine\EngineIds.java", "Java", 0, 0, 0, 0, 48, 7, 10, 65
"c:\Users\ahmed\OneDrive\Desktop\information\college\second term year 3\oop\project\IDS\src\main\java\com\example\gui\Gui.java", "Java", 0, 0, 0, 0, 88, 16, 20, 124
"c:\Users\ahmed\OneDrive\Desktop\information\college\second term year 3\oop\project\IDS\src\main\java\com\example\gui\ScrollBarObserver.java", "Java", 0, 0, 0, 0, 26, 2, 6, 34
"c:\Users\ahmed\OneDrive\Desktop\information\college\second term year 3\oop\project\IDS\src\main\java\com\example\producer\ProducerLive.java", "Java", 0, 0, 0, 0, 29, 1, 7, 37
"c:\Users\ahmed\OneDrive\Desktop\information\college\second term year 3\oop\project\IDS\src\main\java\com\example\producer\ProducerPcap.java", "Java", 0, 0, 0, 0, 29, 1, 5, 35
"c:\Users\ahmed\OneDrive\Desktop\information\college\second term year 3\oop\project\IDS\src\main\java\com\example\util\HexToAscii.java", "Java", 0, 0, 0, 0, 11, 0, 4, 15
"c:\Users\ahmed\OneDrive\Desktop\information\college\second term year 3\oop\project\IDS\src\main\java\com\example\util\PacketParser.java", "Java", 0, 0, 0, 0, 59, 4, 5, 68
"c:\Users\ahmed\OneDrive\Desktop\information\college\second term year 3\oop\project\IDS\src\main\java\com\example\util\RegexPattern.java", "Java", 0, 0, 0, 0, 82, 13, 11, 106
"c:\Users\ahmed\OneDrive\Desktop\information\college\second term year 3\oop\project\IDS\src\main\java\com\example\util\RulesValidation.java", "Java", 0, 0, 0, 0, 26, 4, 2, 32
"c:\Users\ahmed\OneDrive\Desktop\information\college\second term year 3\oop\project\IDS\src\test\java\com\example\AppTest.java", "Java", 0, 0, 0, 0, 11, 6, 4, 21
"Total", "-", 25, 27, 125, 20, 1251, 179, 319, 1946